50
50
64
-
104 104 104 150 104 104 104 104 104 104 104 104 104 104 104 104 104 104 104 104 150 104 104 104 104 104 104 104 104 104 104 104 104 104 104 104 104 121 107 122 104 104 104 104 121 107 107 122 104 104
104 121 107 107 107 107 107 107 107 150 107 107 107 107 107 134 107 107 107 122 150 107 107 134 107 122 104 104 104 104 104 104 104 104 104 104 121 108 000 106 107 122 121 107 108 000 000 106 122 104
104 105 000 000 000 000 000 000 000 000 000 000 000 000 000 200 000 000 000 106 150 000 000 111 000 106 107 122 104 104 104 104 104 104 150 150 150 000 000 000 000 106 108 000 000 000 000 000 106 122
104 150 000 000 000 000 000 000 000 000 000 000 000 000 000 200 000 000 000 000 000 000 000 000 000 000 000 106 122 104 150 104 104 104 104 150 000 000 000 000 000 000 000 000 000 000 000 000 000 103
104 125 101 101 201 150 101 117 113 113 150 101 101 101 101 201 150 102 000 000 000 000 000 000 000 000 000 000 103 104 104 104 104 104 104 105 000 000 000 000 000 000 000 000 000 000 000 000 000 103
104 104 150 150 200 107 107 108 000 000 106 122 104 104 104 200 104 125 101 150 150 150 150 000 000 000 000 000 103 104 104 104 104 121 107 200 000 000 000 000 000 150 150 150 150 150 150 000 000 103
104 104 150 150 000 000 000 000 000 000 000 106 122 121 107 200 150 150 104 104 104 104 150 150 150 150 150 000 200 150 104 104 104 105 000 200 000 000 000 000 000 000 000 000 000 000 000 000 201 126
104 104 150 105 000 000 000 000 000 000 000 000 103 105 000 200 000 150 150 104 150 150 150 150 150 150 150 000 200 150 150 104 150 105 000 201 101 102 000 000 000 000 000 000 000 000 000 000 200 104
104 104 150 150 000 201 150 150 150 150 150 150 150 125 150 200 000 150 150 104 104 150 150 150 150 150 150 150 201 150 150 150 150 150 000 200 107 129 118 101 101 101 102 000 000 000 109 000 200 104
104 150 150 105 000 200 000 000 000 000 000 200 104 104 104 201 150 150 104 104 150 150 150 000 000 000 000 000 200 000 000 000 000 000 000 200 000 000 106 107 122 104 125 150 000 100 127 000 103 104
104 150 104 125 101 200 000 000 000 000 000 200 104 104 500 200 121 107 107 107 150 150 000 000 000 000 000 000 200 000 000 000 000 000 000 200 000 000 000 000 103 104 104 125 101 126 125 201 126 104
104 150 150 150 150 150 150 150 150 150 150 201 150 500 500 200 200 000 000 000 150 000 000 000 000 000 000 000 200 000 000 000 000 000 000 200 000 000 000 100 126 104 104 104 104 104 104 200 104 104
104 150 150 201 000 000 000 000 000 000 000 200 150 500 000 000 200 000 000 000 110 000 000 000 000 109 000 000 200 000 000 000 000 000 000 200 000 000 116 130 134 107 122 104 104 104 104 200 104 104
104 150 000 200 000 000 000 000 000 000 000 200 000 000 100 101 201 101 102 000 124 101 102 000 100 127 000 000 000 000 000 000 000 000 000 200 000 100 127 000 111 000 106 122 104 104 150 200 150 104
104 125 101 201 150 150 150 150 150 150 150 150 000 112 130 107 200 121 108 000 106 107 129 201 130 108 000 150 150 150 150 150 150 150 150 150 113 130 108 000 000 000 000 106 107 107 150 200 104 104
104 150 104 200 000 000 000 000 000 000 000 000 000 000 000 000 200 150 000 000 000 000 000 200 000 000 000 000 000 000 000 000 000 000 000 000 000 000 000 000 000 000 000 000 000 000 000 200 104 104
104 150 150 200 000 000 000 000 000 000 000 000 000 000 000 000 200 150 000 000 000 000 000 200 000 000 000 000 000 000 000 000 000 000 000 000 000 000 000 000 000 000 000 000 000 000 000 200 104 104
104 150 150 150 150 150 150 150 150 150 150 150 150 201 150 150 150 150 000 000 000 000 150 201 000 000 000 000 000 000 000 000 000 000 000 000 000 000 000 000 000 150 150 150 150 101 117 200 122 104
104 150 150 150 150 000 000 000 000 000 000 000 000 200 000 000 000 000 000 000 000 150 150 200 000 000 000 000 000 000 000 000 000 000 000 000 000 000 000 000 000 000 150 150 150 150 105 000 103 104
150 150 150 000 000 000 000 000 000 000 000 000 000 200 000 000 000 000 000 000 150 150 150 200 000 000 000 000 000 000 000 000 000 000 000 000 000 000 000 000 000 000 000 150 150 150 150 000 150 104
150 150 150 150 150 201 150 150 150 150 150 150 000 200 150 150 150 150 150 000 150 150 000 200 000 000 000 000 150 150 150 150 150 150 102 000 000 000 000 000 000 000 000 106 122 150 150 000 150 104
104 150 000 000 000 200 150 000 000 000 000 000 000 200 000 000 000 500 000 000 500 500 000 200 000 000 000 000 000 000 500 000 106 122 125 102 000 000 000 000 000 000 000 000 106 122 150 000 150 104
104 150 150 000 000 200 150 150 000 000 000 000 000 200 000 000 000 500 000 000 000 500 000 000 000 000 000 000 000 000 000 000 000 200 104 125 102 000 000 000 000 000 000 000 000 103 150 000 103 104
104 104 125 150 000 200 150 150 150 201 150 000 000 200 000 000 000 500 000 000 000 500 000 000 000 000 000 150 201 000 000 000 000 200 150 104 125 101 150 150 150 150 150 000 000 106 123 000 150 104
104 104 150 105 000 200 150 150 150 200 150 150 000 200 000 000 000 000 000 000 000 000 000 000 000 000 000 150 200 000 000 000 100 201 150 104 104 104 105 000 000 000 000 000 000 000 111 000 150 104
104 104 104 125 101 200 150 000 000 200 150 150 150 200 000 000 000 000 000 000 000 000 000 000 000 109 000 150 200 000 150 101 126 200 150 104 104 121 108 000 000 000 000 000 000 000 000 000 150 104
104 104 104 104 104 200 000 000 000 200 150 150 150 150 150 150 000 000 000 000 000 000 000 000 100 127 000 150 000 100 126 104 104 200 150 104 121 108 000 000 000 000 000 000 000 000 000 000 150 150
104 104 104 104 104 200 000 000 150 200 000 000 000 000 000 150 150 000 000 000 000 000 000 100 126 105 000 150 000 150 107 107 122 200 150 104 105 000 000 000 000 000 150 150 150 150 150 000 000 103
104 104 104 104 104 200 000 150 150 200 000 000 000 000 000 000 150 150 000 000 000 000 100 150 104 105 000 150 000 000 000 000 106 200 150 121 108 000 000 000 000 000 500 500 500 500 500 000 000 103
104 150 150 150 150 150 150 150 150 200 000 000 000 000 000 000 000 150 150 150 150 201 126 104 104 105 000 000 000 000 000 000 000 200 150 105 000 000 000 000 000 000 000 500 500 000 500 000 000 103
104 104 121 107 122 104 105 000 000 200 000 000 000 000 000 000 000 000 000 000 000 200 104 150 104 105 000 000 000 000 000 000 000 200 104 105 000 000 000 000 000 000 000 500 000 000 500 000 000 103
104 104 105 000 106 122 105 000 000 000 000 000 000 000 000 000 000 000 000 000 000 200 107 107 107 125 101 101 101 102 000 100 101 126 121 108 000 000 000 000 000 000 000 000 000 000 500 000 000 103
104 121 108 000 000 106 123 000 000 000 000 000 000 000 000 000 000 000 000 000 000 200 000 000 000 150 150 150 150 150 000 103 104 121 108 000 000 000 000 000 000 000 000 000 000 000 000 000 000 103
104 105 000 000 000 000 111 000 150 201 150 000 000 000 000 000 000 000 000 000 000 200 000 000 000 000 000 000 150 150 000 120 107 108 000 000 000 000 000 000 000 000 000 000 000 000 000 000 000 103
104 105 000 000 000 000 000 000 000 200 000 000 000 000 000 000 000 000 000 000 000 200 000 000 000 000 000 000 000 000 000 111 000 000 000 000 000 000 000 000 000 000 000 000 000 000 000 000 000 103
104 105 000 109 000 000 000 000 000 200 000 000 000 000 000 000 000 000 000 000 000 200 000 000 000 000 000 000 000 000 000 000 000 000 000 000 000 000 000 000 000 000 000 000 000 000 000 000 000 103
121 108 000 128 118 102 000 000 000 200 000 000 000 000 000 000 000 000 000 000 000 200 000 000 000 000 000 000 000 000 000 000 000 000 000 000 000 000 000 000 000 000 000 000 000 000 000 000 000 103
105 000 000 000 106 125 101 102 000 200 000 000 000 000 000 000 000 000 000 000 000 200 000 000 000 000 000 000 000 000 000 000 000 000 000 000 000 000 000 000 000 000 000 000 000 000 000 000 000 103
105 000 000 000 000 103 104 105 000 000 000 000 000 000 000 000 000 000 000 000 000 200 000 000 000 000 000 000 000 000 000 000 000 000 000 000 000 000 000 000 000 000 000 000 000 000 000 000 000 103
105 000 000 000 000 103 150 150 150 150 150 000 000 000 000 000 000 000 000 000 000 200 000 000 000 000 000 000 000 000 000 000 000 000 000 000 000 000 000 000 000 000 000 000 000 000 000 000 000 103
125 101 201 101 101 150 150 200 000 000 000 000 000 201 150 150 150 150 150 150 150 200 000 000 000 000 000 000 000 000 000 000 000 000 000 000 000 000 000 000 000 000 000 150 150 150 150 000 000 103
104 104 200 104 150 150 000 200 000 000 000 000 000 200 000 103 104 150 150 150 150 200 000 000 000 000 000 000 000 000 000 000 000 000 150 150 150 150 150 150 150 150 150 150 000 000 000 000 000 103
104 104 200 107 150 150 000 200 000 000 000 000 000 200 000 103 121 108 000 150 150 200 000 000 000 000 000 000 000 000 000 000 000 000 000 000 000 000 000 000 000 000 000 000 000 000 000 000 000 103
104 104 200 000 000 000 000 201 113 113 113 113 118 133 101 104 108 000 000 000 000 200 000 000 000 000 000 000 000 000 000 000 000 000 000 000 000 000 000 000 000 000 000 000 000 000 000 000 000 103
104 104 200 000 000 000 000 200 000 000 000 000 106 107 107 108 000 000 000 000 000 200 000 000 000 000 000 000 000 000 000 000 000 000 000 000 000 000 000 000 000 000 000 000 000 000 000 000 100 126
104 104 125 101 102 000 000 200 000 000 000 000 000 000 000 000 000 000 100 101 101 101 101 101 101 101 101 101 101 101 101 101 101 101 101 101 101 101 101 101 101 101 101 101 101 101 101 101 126 104
104 104 104 104 125 102 000 200 000 000 000 000 000 000 000 000 000 100 126 104 104 104 104 104 104 104 104 104 104 104 104 104 104 104 104 104 104 104 104 104 104 104 104 104 104 104 104 104 104 104
104 104 104 104 104 125 101 200 000 000 000 000 000 000 000 000 100 126 104 104 104 104 104 104 104 104 104 104 104 104 104 104 104 104 104 104 104 104 104 104 104 104 104 104 104 104 104 104 104 104
104 104 104 104 104 104 104 125 102 000 000 109 000 000 000 100 126 104 104 104 104 104 104 104 104 104 104 104 104 104 104 104 104 104 104 104 104 104 104 104 104 104 104 104 104 104 104 104 104 104
104 104 104 104 104 104 104 104 125 101 000 133 101 101 101 126 104 104 104 104 104 104 104 104 104 104 104 104 104 104 104 104 104 104 104 104 104 104 104 104 104 104 104 104 104 104 104 104 104 104
-
