38
17
64
-
000 000 000 000 000 000 000 000 000 000 000 000 000 000 000 000 000 000 000 000 115 000 000 000 000 000 000 000 000 000 000 000 000 000 000 000 000 000
000 000 000 000 000 000 000 000 000 000 000 000 000 000 000 000 000 000 000 000 115 000 000 000 000 000 000 000 000 000 000 115 000 000 000 000 000 000
115 000 000 000 000 000 000 000 115 115 000 000 000 000 000 000 000 000 000 115 115 000 000 000 000 000 000 000 000 115 115 115 000 000 000 000 000 000
000 000 000 000 000 000 000 115 000 000 115 000 000 000 000 000 000 000 000 115 000 000 000 000 000 000 000 000 000 500 500 500 000 000 000 000 000 000
000 000 000 000 000 000 000 115 000 000 115 000 000 000 000 115 115 115 115 115 000 000 000 000 000 000 000 000 000 000 500 500 000 000 000 000 000 000
000 000 000 000 000 000 000 000 115 115 000 000 000 000 000 000 000 000 000 000 000 000 000 000 000 000 000 000 000 000 500 500 000 000 115 000 000 150
000 000 000 000 000 000 000 000 000 000 000 000 000 000 000 000 000 000 000 000 000 000 000 000 115 000 000 000 000 000 000 500 000 000 000 000 000 150
000 000 000 000 000 000 000 000 000 000 000 000 000 000 000 000 000 000 000 000 000 000 000 000 000 000 000 000 000 000 000 000 000 000 000 000 000 150
000 000 000 115 000 000 000 000 000 000 000 000 000 000 115 000 000 000 000 000 000 000 000 000 000 000 000 000 000 000 000 000 000 000 000 000 150 150
000 000 000 115 000 000 000 000 000 000 000 000 000 000 115 000 000 000 000 000 000 000 000 000 000 000 000 000 000 000 000 000 000 000 000 000 150 150
100 101 101 101 101 101 101 101 101 101 101 101 101 101 101 101 150 150 000 000 000 000 000 100 101 101 101 101 101 101 101 101 101 101 101 101 101 102
106 107 107 107 107 107 107 107 107 107 107 107 107 107 107 107 107 150 150 000 000 000 000 106 107 107 107 107 107 107 107 107 107 107 107 107 107 108 
000 000 000 000 000 000 000 000 000 000 000 000 000 000 000 000 000 000 150 150 000 000 000 000 000 000 000 500 500 500 500 000 000 000 000 000 000 000
000 000 000 000 000 000 000 000 000 000 000 000 000 000 000 000 000 000 000 150 150 000 000 000 000 000 000 500 500 000 500 000 000 000 000 000 000 000
000 000 000 000 000 000 000 000 000 000 000 000 000 000 000 000 000 000 000 000 150 150 000 000 000 000 000 000 500 000 000 000 000 000 000 000 000 000
000 000 000 000 000 000 000 000 000 000 000 000 000 000 000 000 000 000 000 000 000 150 150 000 000 000 000 000 000 000 000 000 000 000 000 000 000 000
100 101 101 101 101 101 101 101 101 101 101 101 101 101 101 101 101 101 101 101 101 101 150 150 101 101 101 101 101 101 101 101 101 101 101 102 000 000
-
