50
50
64
-
;
;
;
;
;
;
000 000 000 000 000 000 000 000 000 000 000 000 000 000 000 000 000 000 000 000 000 000 000 000 000 000 000 000 000 000 000 000 000 000 000 000 000 000 000 000 000 000 000 000 000 000 000 000 000 000
000 000 000 000 000 000 000 000 000 000 000 000 000 000 000 000 000 000 000 000 000 000 000 000 000 000 000 000 000 000 000 000 000 000 000 000 000 000 000 000 000 000 000 000 000 000 000 000 000 000
000 000 000 000 000 000 000 000 000 000 000 000 000 000 000 000 000 000 000 000 000 000 000 000 000 000 000 000 201 150 150 150 150 150 150 150 000 000 000 000 000 000 000 000 000 000 000 000 000 000
000 000 000 000 000 000 000 000 000 000 000 000 000 000 000 000 000 000 000 000 000 000 000 000 000 000 000 000 200 000 000 000 000 000 000 000 000 000 000 000 000 112 113 102 000 000 000 000 000 000
000 000 000 000 000 000 000 000 000 000 000 000 000 000 000 000 000 000 000 000 000 000 000 000 000 000 000 000 200 000 000 000 000 000 000 000 000 000 000 000 000 500 500 106 113 113 113 102 000 000
000 000 000 000 000 000 000 000 000 150 150 150 150 201 000 000 000 000 000 000 000 000 000 000 000 000 000 000 200 000 000 000 000 000 000 000 000 000 000 000 000 500 500 500 500 500 500 106 113 113
000 000 000 000 000 150 150 150 000 000 000 000 000 200 000 000 000 000 000 000 000 000 000 000 000 000 000 000 200 000 000 000 000 000 000 000 000 000 000 000 000 500 500 500 500 500 500 000 500 500
000 000 000 000 150 150 000 000 000 000 000 000 000 200 000 000 000 000 000 000 000 000 000 000 000 000 000 000 200 000 000 000 000 000 000 000 000 000 000 000 000 500 500 500 500 500 500 000 500 500
000 000 000 000 000 000 000 000 000 000 000 000 000 200 000 000 000 000 000 000 000 000 000 000 000 000 000 000 200 000 000 000 000 000 000 000 000 000 000 000 000 500 000 500 500 500 500 000 000 500
000 000 000 000 000 000 000 000 000 000 000 000 000 200 000 000 000 000 000 000 000 000 000 000 000 000 000 000 200 000 000 000 000 000 000 000 000 000 000 000 000 000 000 500 500 500 500 000 000 500
000 000 000 000 000 000 000 000 000 000 000 000 000 200 000 000 000 000 000 000 000 000 000 000 000 000 000 000 200 000 000 000 000 000 000 000 000 000 000 000 000 000 000 500 500 500 500 000 000 500
000 000 000 000 000 000 000 000 000 000 000 000 000 200 000 000 000 000 000 000 000 000 000 000 000 000 000 000 200 000 000 000 000 000 000 000 000 000 000 000 000 000 000 500 500 500 000 000 000 000
000 000 000 000 000 000 000 000 000 000 000 000 000 200 150 150 150 150 150 150 000 000 000 000 000 000 000 000 200 000 000 000 000 000 000 000 000 000 000 000 000 000 000 000 500 500 000 000 000 000
000 000 000 000 000 000 000 000 000 000 000 000 000 200 000 000 000 000 000 000 000 000 000 000 150 150 150 150 150 150 150 150 150 150 000 000 000 000 000 000 000 000 000 000 500 500 000 000 000 000
000 000 000 000 000 000 000 000 000 000 000 000 000 200 000 000 000 000 000 000 000 000 000 000 000 000 000 000 000 000 000 000 000 150 150 000 000 000 000 000 000 000 000 000 000 500 000 000 000 000
000 000 000 000 000 000 000 000 000 000 000 000 000 200 000 000 000 000 000 000 000 000 000 000 000 000 000 000 000 000 000 000 000 000 150 150 000 000 000 000 000 000 000 000 000 500 000 000 000 000
000 000 000 000 000 000 000 000 000 000 000 000 000 200 000 000 000 000 000 000 000 000 000 000 000 000 000 000 000 000 000 000 000 000 000 150 150 000 000 000 000 000 000 000 000 500 000 000 000 000
000 000 000 000 000 000 000 000 000 000 150 000 000 200 000 000 000 000 000 000 000 000 000 000 000 000 000 000 000 000 000 000 000 000 000 000 150 150 150 150 150 150 150 000 000 000 000 000 000 000
000 000 000 000 000 000 000 000 000 000 150 000 000 200 000 000 000 000 000 000 000 000 000 000 000 000 000 000 000 000 000 000 000 000 000 000 000 000 000 000 000 000 000 000 000 000 000 000 000 000
000 000 000 000 000 000 000 000 000 000 150 000 000 200 000 000 000 000 000 000 000 000 000 000 000 000 000 000 000 000 000 000 000 000 000 000 000 000 000 000 000 000 000 000 000 000 000 000 000 000
000 000 000 000 000 000 000 000 000 000 150 150 150 150 150 150 000 000 000 000 000 000 000 000 000 000 000 000 000 000 000 000 000 000 000 000 000 000 000 000 000 000 000 000 000 150 150 150 150 150
000 000 000 000 000 000 000 000 000 000 000 000 000 000 000 150 150 000 000 000 000 000 000 000 000 000 000 000 000 000 000 000 000 000 000 000 000 000 000 000 000 000 000 000 150 150 000 000 000 000
000 000 000 000 000 000 000 000 000 000 000 000 000 000 000 000 150 150 000 000 000 000 150 150 150 150 150 150 150 150 150 150 150 150 150 000 000 000 000 000 000 000 000 150 150 000 000 000 000 000
000 000 000 000 000 000 000 000 000 000 000 000 000 000 000 000 000 150 150 150 150 201 150 150 150 150 150 150 150 150 150 150 150 150 150 000 000 000 000 000 000 000 150 150 500 000 000 000 000 000
000 000 000 000 000 000 000 000 000 000 000 000 000 000 000 000 000 000 000 000 000 200 000 000 000 000 000 000 500 000 000 000 000 000 000 000 000 000 000 000 000 150 150 500 500 000 000 000 000 000
000 000 000 000 000 000 000 000 000 000 000 000 000 000 000 000 000 000 000 000 000 200 000 000 000 000 000 000 500 000 000 000 000 000 000 000 201 150 150 150 150 150 500 500 500 000 000 000 000 000
000 000 000 000 000 000 000 000 000 000 000 000 000 000 000 000 000 000 000 000 000 200 000 000 000 000 000 000 000 000 000 000 000 000 000 000 200 500 000 000 000 000 500 500 500 000 000 000 000 000
000 000 000 000 000 000 000 000 000 000 000 000 000 000 000 000 000 000 000 000 000 200 000 000 000 000 000 000 000 000 000 000 000 000 000 000 200 500 000 000 000 000 000 500 500 000 000 000 000 000
000 000 000 000 000 000 000 000 000 000 000 000 000 000 000 000 000 000 000 000 000 200 000 000 000 000 000 000 000 000 000 000 000 000 000 000 200 500 000 000 000 000 000 500 500 000 000 000 000 000
000 000 000 000 000 000 000 000 000 000 000 000 000 000 000 000 000 000 000 000 000 200 000 000 000 000 000 000 000 000 000 000 000 000 000 000 200 000 000 000 000 000 000 500 500 000 000 000 000 000
000 000 000 000 000 000 000 000 000 000 000 000 000 000 000 000 000 000 000 000 000 200 000 000 000 000 000 000 000 000 000 000 000 000 000 000 200 000 000 000 000 000 000 500 000 000 000 000 000 000
000 000 000 000 000 000 000 000 000 000 000 000 000 000 000 000 000 000 000 000 000 200 000 000 000 000 000 000 000 000 000 000 000 000 000 000 200 000 000 000 000 000 000 500 000 000 000 000 000 000
000 000 000 000 000 000 000 000 000 000 000 000 000 000 000 000 000 000 000 000 000 200 000 000 000 000 000 000 000 000 000 000 000 000 000 000 200 000 000 000 000 000 000 500 000 000 000 000 000 000
000 000 000 000 000 000 000 000 000 000 000 000 000 000 000 000 000 000 000 000 000 200 000 000 000 000 000 000 000 000 000 000 000 000 000 000 000 000 000 000 000 000 000 000 000 000 000 000 000 000
000 000 000 000 000 000 000 000 000 000 000 000 000 000 000 000 000 000 000 000 000 200 000 000 000 000 000 000 000 000 000 000 000 000 000 000 000 000 000 000 000 000 000 150 150 150 150 000 000 000
000 000 000 000 000 000 000 000 000 000 000 000 000 000 000 000 000 000 000 000 000 200 000 000 000 000 000 000 000 000 000 000 000 000 150 150 150 150 150 150 150 150 150 150 000 000 000 000 000 000
000 000 000 000 000 000 000 000 000 000 000 000 000 000 000 000 000 000 000 000 000 200 000 000 000 000 000 000 000 000 000 000 000 000 000 000 000 000 000 000 000 000 000 000 000 000 000 000 000 100
000 000 000 000 000 000 000 000 000 000 000 000 000 000 000 000 000 000 000 000 000 200 000 000 000 000 000 000 000 000 000 000 000 000 000 000 000 000 000 000 000 000 000 000 000 000 000 000 000 103
000 000 000 000 000 000 000 000 000 000 000 000 000 000 000 000 000 000 000 000 000 200 000 000 000 000 000 000 000 000 000 000 000 000 000 000 000 000 000 000 000 000 000 000 000 000 000 000 100 126
000 000 000 000 000 000 000 000 000 000 000 000 000 000 000 000 000 000 100 101 101 101 101 101 101 101 101 101 101 101 101 101 101 101 101 101 101 101 101 101 101 101 101 101 101 101 101 101 126 104
102 000 000 000 000 000 000 000 000 000 000 000 000 000 000 000 000 100 126 104 104 104 104 104 104 104 104 104 104 104 104 104 104 104 104 104 104 104 104 104 104 104 104 104 104 104 104 104 104 104
105 000 000 000 000 000 000 000 000 000 000 000 000 000 000 000 100 126 104 104 104 104 104 104 104 104 104 104 104 104 104 104 104 104 104 104 104 104 104 104 104 104 104 104 104 104 104 104 104 104
105 000 000 000 109 000 000 000 000 000 000 109 000 000 000 100 126 104 104 104 104 104 104 104 104 104 104 104 104 104 104 104 104 104 104 104 104 104 104 104 104 104 104 104 104 104 104 104 104 104
125 101 101 101 133 101 101 101 101 101 101 133 101 101 101 126 104 104 104 104 104 104 104 104 104 104 104 104 104 104 104 104 104 104 104 104 104 104 104 104 104 104 104 104 104 104 104 104 104 104
-
